+-+-+-+-+-+-+-+-+-+-+-+-+-+-+-+-+-+-+-+-+-+-+-+-+-+-+-+-+-+-+-+-+-+-+-+-+-+-+-+-+
I           | |   |     |   |     |             |   |   |   |       |   |     | |
+-+-+-+-+-+ + + + + +-+-+ + + +-+ + +-+ +-+-+-+ + + + + + + +-+-+ + + + + +-+ + +
|       | | |   |   |     | | |   | |   |   | | | |   |   |     | |   | | | |   |
+ +-+-+ + + + +-+-+ + +-+-+ + +-+-+ + +-+-+ + + + +-+-+-+-+ +-+ + +-+-+ + + + +-+
| | |     |   |   | | |     |       | |   | | | |     |     | | | |   |   |     |
+ + + +-+-+-+-+ + + + + +-+-+-+ +-+-+ + + + + + +-+-+ + + +-+ + + +-+ +-+-+-+ + +
|   |   |       |   | | |     | | |   | | |   |   |   | | | |   |   |   |     | |
+-+-+ + + +-+-+-+-+-+ + + + +-+ + + +-+ + + +-+-+ + +-+ + + +-+-+-+ +-+ + +-+-+ +
|     |   |   |     | |   |     |   |   | | |   | |   | | | |     | | | | |   | |
+ + +-+-+-+ + +-+ +-+ +-+-+-+-+-+ +-+ +-+ + + + + +-+ + + + + + + + + + + +-+ + +
| | | |   | |     |   |         |   |   | | | |       | | | | | |       |   | | |
+ + + + +-+ + +-+-+ +-+ +-+-+-+-+-+ + + + + +-+-+-+-+-+-+ + + + +-+ +-+-+ + + + +
| | | |     |     | |         |   | | | |     |         | | | |   | |   | |   | |
+ + + +-+ +-+ +-+ + + +-+-+-+ + + + + +-+-+ + + +-+-+-+ + + +-+-+-+ + + +-+-+ + +
| |       |   | | |   |       | | | |     | | |     |   |           | |   |   | |
+ +-+-+-+-+ +-+ + + + + +-+-+-+ + + +-+-+ + +-+-+-+ +-+-+-+ +-+-+-+-+-+-+ +-+-+ +
| | |     |     |   | |         | | |     |       |         |   |   |     |   | |
+ + + +-+ +-+-+ +-+-+-+-+-+-+-+-+-+ + +-+-+-+-+-+ +-+-+ +-+-+-+ + + + +-+-+ + + +
| | | | |   |   |   |         |     |   |   |   |     |     |   | | | |   | | | |
+ + + + + + + +-+ +-+ +-+-+-+ + +-+-+-+ + + +-+ +-+ + +-+-+ + +-+ + + + +-+ + +-+
|   | |   | | |     | |   |   |         | |   |   | |   |   | | | | | |     |   |
+-+-+ +-+-+-+ + +-+ + + + +-+-+-+-+-+-+-+ +-+ +-+ + +-+ + +-+ + + +-+ +-+-+-+-+ +
|   |         |   | |   |           |   |   |   | | |   |   |   |   |   |   | | |
+ +-+-+-+-+-+-+ + + +-+-+-+-+-+-+-+ + + +-+ +-+ + + + +-+-+ + +-+-+ +-+ + + + + +
|         |     | |   |       |   |   | |   |   | | |   | | | |   | |   | | |   |
+ +-+-+-+ + + +-+ +-+-+ +-+-+ + + +-+ + + +-+-+-+ + +-+ + + + +-+ + + +-+ + +-+ +
|   | |   | | | | |     |   |   |     | |     |     |   |   |     | | |   |     |
+-+ + + +-+ + + + + +-+-+ + +-+-+-+ +-+ +-+-+ + +-+-+ + +-+-+-+-+ + + + +-+-+ +-+
|   |     | |   | |   |   |   |     | | |   |   |     |   |     |     | |   |   |
+-+ +-+ + +-+-+-+ +-+ +-+-+-+ + +-+-+ + + +-+-+-+ +-+-+ + + + +-+-+ +-+ +-+ +-+ +
|   |   | |     |     |     | |   |     |   |       |   | | | |   |   |   | |   |
+ +-+-+-+ + +-+ +-+-+-+ +-+ + + + +-+-+-+ + + +-+-+-+ +-+ + +-+ + + +-+-+ + + +-+
|     |   |   |           | | | |     |   |   |     |   | | |   | |     | |   | |
+-+-+ + + +-+ +-+-+-+-+-+-+ + + +-+-+ + +-+-+-+ +-+ +-+ + + + +-+ +-+ +-+ +-+-+ +
|     | |   |     |   |   | | |     | |   |     |   |   |     |   |   |   |   | |
+ +-+-+-+-+ +-+-+ + + + + + + +-+-+ + +-+-+ +-+-+-+ + +-+-+-+-+-+ + + + +-+ + + +
|         |       | | | | | |     | |     |   |   | |   |       |   |   |   |   |
+-+-+-+-+ +-+-+-+-+-+ + + + +-+-+ +-+-+-+ +-+ + + + + +-+ +-+-+ + +-+-+-+-+-+-+ +
|       |       |   |   | | |     |     |   |   | |   |   |   |       |   | |   |
+ +-+-+-+-+-+ + + + + +-+ + + +-+-+ +-+-+-+ +-+-+ +-+-+ +-+ + +-+-+-+ +-+ + + +-+
|   |     |   |   | |   | | | |   |       |   |   |   | |   |   |     |     | | |
+-+ + +-+ + +-+-+-+ +-+ + + + + + +-+-+-+ +-+ + +-+ + + +-+ +-+-+ +-+-+ +-+-+ + +
| | |   |   |     | |   | | |   | |     |   | |     | | |   |     |       |   | |
+ + +-+ +-+-+ +-+ + + +-+-+ +-+-+ +-+-+ +-+ + +-+-+-+-+ + +-+ +-+-+ +-+-+ + +-+ +
| |   | |   | | | |   |         |     | |   |           | |         |   | | |   |
+ +-+ + + +-+ + + +-+-+ +-+-+-+ +-+-+ + + +-+-+-+ +-+-+-+ + +-+-+-+-+ + + + + +-+
|   |   | |   | |     |   |     |   | | | |           |   |       |   | |   |   |
+ +-+-+-+ + +-+ +-+-+ +-+ + +-+-+-+ + + + +-+-+-+ +-+ + +-+-+-+-+ +-+-+ +-+-+-+ +
|   |   | | |   |   | |   |   |     |   |   |     |   |         | |   |     |   |
+-+ +-+ + + + +-+ + + +-+-+ + + +-+ + +-+-+ + +-+-+ +-+-+-+-+-+ + + + +-+-+ + +-+
| | |   | | | |   | |     | |   |   |         |     |   | |   | | | |         | |
+ + + +-+ + + + +-+ +-+-+ +-+-+-+ + +-+ +-+ +-+ + +-+-+ + + +-+ + + +-+-+-+-+-+ +
| | | |   | | | |   |   |         |   | |   |   |       | |   | |   |     |     |
+ + + + +-+ + + + +-+ + +-+-+-+-+-+ + +-+ +-+-+-+-+ + +-+ +-+ + +-+-+-+-+ +-+-+ +
|   |         | |   | | |         | |   | |   |   | | |   |   | |       |     | |
+ +-+-+-+-+ +-+ +-+ + + + +-+-+-+ + +-+ + + + + + + + +-+ + +-+ +-+-+-+ +-+-+ + +
| |         | | | | | |   | |   |   |   |   | | |   |       |     |   |   |   | |
+ +-+-+-+-+-+ + + + +-+-+-+ + + +-+-+-+ +-+-+ +-+-+-+-+-+ +-+ + + + + +-+ +-+ + +
|       | |     |     |     | |   |   |       |         | |   | |   |   |   | | |
+ +-+-+ + + +-+-+-+ + + +-+ + +-+ +-+ +-+ + +-+ +-+-+-+ + +-+ + +-+-+-+ +-+ + + +
| |   | |   |   |   | | | |   |     |   | | | |       |       | |     |     |   |
+ + + + + +-+-+ + +-+ + + +-+-+-+-+ + + +-+ + +-+-+ + +-+-+-+-+ + +-+ +-+-+-+-+ +
|   | | | |     | |       |   |   |   |     | |   | |         |   |     |       |
+-+-+ +-+ + +-+-+ + +-+ +-+ + + +-+-+-+-+-+-+ + + +-+-+-+ +-+ +-+-+-+ + +-+-+ +-+
|   | |   | |     | |     | | | |       |   |   |         |   |   |   | |       |
+ + + + +-+ + +-+-+ + +-+-+ + + + +-+-+ + + +-+-+-+-+-+-+-+ +-+ + + +-+ + +-+ +-+
| | |   |   |   |   | |     | | |     |   |         |     | |   |   | |   | |   |
+ + +-+-+ +-+-+ + +-+ + +-+-+ + +-+ + +-+-+-+-+-+-+ + + +-+ + +-+-+-+ +-+-+ +-+ +
| |       |   | |   | |     |   |   |     |   |   |   |     | |   | | | |       |
+ +-+-+-+-+-+ +-+-+ + +-+-+ +-+-+-+-+-+-+ + + + + +-+-+-+-+-+ +-+ + + + + + +-+ +
|           |       |   | |       |   | |   |   |   |     |   |         | |   | |
+ + +-+-+-+ +-+-+-+-+-+ + +-+-+-+ + + + +-+-+-+-+ +-+ +-+-+ +-+ +-+-+ +-+ +-+-+ +
| | |     |               |     | | | | |       |   |       | | |   |   |     | |
+ +-+ +-+ +-+-+-+-+-+-+-+ + +-+ + +-+ + +-+-+-+ +-+ +-+-+-+-+ + + + +-+ +-+-+ + +
|     |   |   |     |   | | | | | |                 |       |   | | |         | |
+-+ +-+ +-+-+ + +-+-+ + +-+ + + + + + +-+-+-+-+ +-+-+ +-+-+ +-+-+ +-+ +-+-+-+-+-+
| |   |       | |     | |   | | |   |   | |     |   | |   |           |   |     |
+ +-+ +-+-+-+ + + + +-+ + + + + +-+-+-+ + + +-+-+-+ + + + +-+-+-+-+-+-+ + + +-+ +
|     |       |   |   |   |   |           |         |   |               |   |   O
+-+-+-+-+-+-+-+-+-+-+-+-+-+-+-+-+-+-+-+-+-+-+-+-+-+-+-+-+-+-+-+-+-+-+-+-+-+-+-+-+
