+-+-+-+-+-+-+-+-+-+-+-+-+-+-+-+-+-+-+-+-+
I       |     |   |   |     |       |   |
+ +-+-+-+ + + + + + + + + + + +-+ +-+ + +
|         | |   |   | | | | | | | |   | |
+-+-+-+-+-+ +-+-+-+-+ + +-+ + + + + +-+-+
| |             |     |   |   |   |     |
+ + +-+-+-+-+-+ + +-+-+ + +-+-+-+ +-+-+ +
|   |           | |   | |   |   | | |   |
+-+-+ +-+-+-+-+-+ + + + +-+ + + + + + + +
|     |   |   |   | | | | | | | |   | | |
+ +-+-+ + + + + +-+ + + + + + + +-+-+ + +
| |   | | | |   |   | | |   | |       | |
+ +-+ + + + +-+-+ +-+ + +-+-+-+ +-+-+-+-+
|     | | |   |   | |       |   |   |   |
+-+-+-+ + +-+ + + + +-+-+-+ + +-+ + + + +
| |   | |     | | |     |   |   | |   | |
+ + + + +-+-+-+ + + +-+ + +-+ + + +-+ + +
| | |           |   |   | |   | | |   | |
+ + +-+ +-+-+ +-+-+-+ +-+ + +-+ +-+ +-+ +
|   | | |   |   |     |   | | | |     | |
+-+-+ + + +-+-+ + +-+-+ +-+ + + + +-+ + +
|   |   |       | |     | | | |   |   | |
+ +-+-+-+-+-+-+-+ + + +-+ + + +-+-+ +-+ +
| |             | | |   |   | |   | | | |
+ + +-+-+-+-+ + + + +-+ + +-+ + + + + + +
| |     |   | |   | | | | | |   |   |   |
+ + +-+ + + + +-+-+ + + + + + +-+-+ +-+-+
|   |   | |   |       |   | | |   |   | |
+-+-+ +-+-+-+-+-+-+ +-+-+ + + + +-+-+ + +
|   | |       |     |   | |   | |   | | |
+ + +-+ +-+ +-+ +-+-+-+ +-+-+-+ + + + + +
| |   |   |   |   |   |   | |   | | | | |
+ +-+ +-+ +-+ +-+ +-+ + + + + +-+ + + + +
| | |       | |   |   | | | | | | | | | |
+ + +-+ + +-+ + +-+ +-+-+ + + + + +-+ + +
|   |   | |   |   |     |       |   | | |
+-+-+ +-+-+ +-+-+ +-+-+ +-+-+ +-+-+ + + +
|     |   | |                     |   | |
+ +-+-+ + + +-+-+ +-+-+ +-+-+-+-+-+-+-+ +
|       | |       |                     O
+-+-+-+-+-+-+-+-+-+-+-+-+-+-+-+-+-+-+-+-+